......................
......................
......................
......................
......................
......................
......................
.......1..33..1.......
.2...3...4..4...3...2.
...3...4..11..4...3...
.3...4..22..22..4...3.
...4...2..22..2...4...
.4..1.1.1.11.1.1.1..4.