......................
......................
......................
......................
......................
......................
..144..........411....
...321...123..321..11.
.41232...4...23111..4.
.41...123....32.12214.